date (International) Month,date (International) Week,date (International) Year,current (Domestic),current (International),Total Flights,Weekly Total Flights
Jan,Week 2,2019,24117,4636,28753,203187
Jan,Week 2,2019,25652,4383,30035,203187
Jan,Week 2,2019,25227,4065,29292,203187
Jan,Week 2,2019,25746,4153,29899,203187
Jan,Week 2,2019,26678,4308,30986,203187
Jan,Week 2,2019,26142,4383,30525,203187
Jan,Week 2,2019,19078,4619,23697,203187
Jan,Week 3,2019,22374,4361,26735,198507
Jan,Week 3,2019,25143,4200,29343,198507
Jan,Week 3,2019,24941,3914,28855,198507
Jan,Week 3,2019,25572,4103,29675,198507
Jan,Week 3,2019,26933,4314,31247,198507
Jan,Week 3,2019,26494,4394,30888,198507
Jan,Week 3,2019,17378,4386,21764,198507
Jan,Week 4,2019,19648,4117,23765,195397
Jan,Week 4,2019,24720,4161,28881,195397
Jan,Week 4,2019,24154,3832,27986,195397
Jan,Week 4,2019,25355,3963,29318,195397
Jan,Week 4,2019,26471,4172,30643,195397
Jan,Week 4,2019,26372,4338,30710,195397
Jan,Week 4,2019,19536,4558,24094,195397
Jan,Week 5,2019,23153,4308,27461,193211
Jan,Week 5,2019,23782,3946,27728,193211
Jan,Week 5,2019,24144,3710,27854,193211
Jan,Week 5,2019,23283,3835,27118,193211
Jan,Week 5,2019,25006,4038,29044,193211
Feb,Week 5,2019,26168,4233,30401,193211
Feb,Week 5,2019,19089,4516,23605,193211
Feb,Week 6,2019,20933,4223,25156,197414
Feb,Week 6,2019,25576,4073,29649,197414
Feb,Week 6,2019,24743,3785,28528,197414
Feb,Week 6,2019,25547,3801,29348,197414
Feb,Week 6,2019,26376,4108,30484,197414
Feb,Week 6,2019,26198,4229,30427,197414
Feb,Week 6,2019,19304,4518,23822,197414
Feb,Week 7,2019,22862,4275,27137,200801
Feb,Week 7,2019,24601,4083,28684,200801
Feb,Week 7,2019,23259,3481,26740,200801
Feb,Week 7,2019,26023,3817,29840,200801
Feb,Week 7,2019,27474,4263,31737,200801
Feb,Week 7,2019,27255,4432,31687,200801
Feb,Week 7,2019,20240,4736,24976,200801
Feb,Week 8,2019,21455,4341,25796,203181
Feb,Week 8,2019,25865,4243,30108,203181
Feb,Week 8,2019,26571,4044,30615,203181
Feb,Week 8,2019,24907,4003,28910,203181
Feb,Week 8,2019,26939,4306,31245,203181
Feb,Week 8,2019,26843,4455,31298,203181
Feb,Week 8,2019,20434,4775,25209,203181
Feb,Week 9,2019,23134,4387,27521,207143
Feb,Week 9,2019,24898,4243,29141,207143
Feb,Week 9,2019,26183,4087,30270,207143
Feb,Week 9,2019,26758,4134,30892,207143
Feb,Week 9,2019,27532,4379,31911,207143
Mar,Week 9,2019,27107,4463,31570,207143
Mar,Week 9,2019,21050,4788,25838,207143
Mar,Week 10,2019,23879,4450,28329,212717
Mar,Week 10,2019,25747,4286,30033,212717
Mar,Week 10,2019,26730,4159,30889,212717
Mar,Week 10,2019,27124,4234,31358,212717
Mar,Week 10,2019,28138,4443,32581,212717
Mar,Week 10,2019,27791,4528,32319,212717
Mar,Week 10,2019,22306,4902,27208,212717
Mar,Week 11,2019,25167,4588,29755,214242
Mar,Week 11,2019,26867,4428,31295,214242
Mar,Week 11,2019,27277,4208,31485,214242
Mar,Week 11,2019,25927,4257,30184,214242
Mar,Week 11,2019,27454,4408,31862,214242
Mar,Week 11,2019,27852,4469,32321,214242
Mar,Week 11,2019,22451,4889,27340,214242
Mar,Week 12,2019,25339,4510,29849,216151
Mar,Week 12,2019,26711,4350,31061,216151
Mar,Week 12,2019,27227,4123,31350,216151
Mar,Week 12,2019,27616,4300,31916,216151
Mar,Week 12,2019,28175,4419,32594,216151
Mar,Week 12,2019,27725,4407,32132,216151
Mar,Week 12,2019,22415,4834,27249,216151
Mar,Week 13,2019,25429,4532,29961,216487
Mar,Week 13,2019,26800,4404,31204,216487
Mar,Week 13,2019,27219,4150,31369,216487
Mar,Week 13,2019,27560,4347,31907,216487
Mar,Week 13,2019,28209,4448,32657,216487
Mar,Week 13,2019,27648,4517,32165,216487
Mar,Week 13,2019,22324,4900,27224,216487
Mar,Week 14,2019,25349,4619,29968,215659
Apr,Week 14,2019,26610,4404,31014,215659
Apr,Week 14,2019,27079,4181,31260,215659
Apr,Week 14,2019,27441,4336,31777,215659
Apr,Week 14,2019,28239,4457,32696,215659
Apr,Week 14,2019,27849,4481,32330,215659
Apr,Week 14,2019,21810,4804,26614,215659
Apr,Week 15,2019,25141,4530,29671,213888
Apr,Week 15,2019,26780,4306,31086,213888
Apr,Week 15,2019,27304,4146,31450,213888
Apr,Week 15,2019,26913,4270,31183,213888
Apr,Week 15,2019,27742,4397,32139,213888
Apr,Week 15,2019,28013,4508,32521,213888
Apr,Week 15,2019,21071,4767,25838,213888
Apr,Week 16,2019,23903,4434,28337,211368
Apr,Week 16,2019,26587,4311,30898,211368
Apr,Week 16,2019,27230,4158,31388,211368
Apr,Week 16,2019,27478,4329,31807,211368
Apr,Week 16,2019,28399,4455,32854,211368
Apr,Week 16,2019,26066,4394,30460,211368
Apr,Week 16,2019,20821,4803,25624,211368
Apr,Week 17,2019,24243,4536,28779,213875
Apr,Week 17,2019,27302,4337,31639,213875
Apr,Week 17,2019,27243,4222,31465,213875
Apr,Week 17,2019,27463,4344,31807,213875
Apr,Week 17,2019,28407,4430,32837,213875
Apr,Week 17,2019,27367,4411,31778,213875
Apr,Week 17,2019,20806,4764,25570,213875
Apr,Week 18,2019,25354,4506,29860,215202
Apr,Week 18,2019,26922,4320,31242,215202
Apr,Week 18,2019,26838,4143,30981,215202
May,Week 18,2019,27587,4247,31834,215202
May,Week 18,2019,28613,4313,32926,215202
May,Week 18,2019,27852,4348,32200,215202
May,Week 18,2019,21515,4644,26159,215202
May,Week 19,2019,25615,4414,30029,216075
May,Week 19,2019,27210,4302,31512,216075
May,Week 19,2019,27480,4145,31625,216075
May,Week 19,2019,27475,4249,31724,216075
May,Week 19,2019,28463,4354,32817,216075
May,Week 19,2019,28251,4401,32652,216075
May,Week 19,2019,21105,4611,25716,216075
May,Week 20,2019,24606,4394,29000,216586
May,Week 20,2019,27296,4285,31581,216586
May,Week 20,2019,27614,4207,31821,216586
May,Week 20,2019,28057,4293,32350,216586
May,Week 20,2019,28868,4416,33284,216586
May,Week 20,2019,28461,4410,32871,216586
May,Week 20,2019,21030,4649,25679,216586
May,Week 21,2019,25395,4429,29824,217216
May,Week 21,2019,27181,4313,31494,217216
May,Week 21,2019,27390,4202,31592,217216
May,Week 21,2019,28143,4309,32452,217216
May,Week 21,2019,28691,4433,33124,217216
May,Week 21,2019,28533,4473,33006,217216
May,Week 21,2019,21039,4685,25724,217216
May,Week 22,2019,21212,4390,25602,208566
May,Week 22,2019,24998,4329,29327,208566
May,Week 22,2019,26472,4192,30664,208566
May,Week 22,2019,26819,4204,31023,208566
May,Week 22,2019,28392,4413,32805,208566
May,Week 22,2019,28142,4486,32628,208566
Jun,Week 22,2019,21805,4712,26517,208566
Jun,Week 23,2019,25209,4479,29688,220332
Jun,Week 23,2019,27254,4371,31625,220332
Jun,Week 23,2019,27721,4296,32017,220332
Jun,Week 23,2019,27971,4344,32315,220332
Jun,Week 23,2019,29008,4613,33621,220332
Jun,Week 23,2019,28643,4661,33304,220332
Jun,Week 23,2019,22821,4941,27762,220332
Jun,Week 24,2019,25330,4656,29986,224603
Jun,Week 24,2019,27342,4537,31879,224603
Jun,Week 24,2019,28567,4496,33063,224603
Jun,Week 24,2019,28924,4570,33494,224603
Jun,Week 24,2019,29503,4645,34148,224603
Jun,Week 24,2019,28994,4686,33680,224603
Jun,Week 24,2019,23351,5002,28353,224603
Jun,Week 25,2019,25620,4695,30315,224091
Jun,Week 25,2019,27636,4583,32219,224091
Jun,Week 25,2019,28338,4492,32830,224091
Jun,Week 25,2019,28551,4618,33169,224091
Jun,Week 25,2019,28837,4632,33469,224091
Jun,Week 25,2019,28909,4750,33659,224091
Jun,Week 25,2019,23343,5087,28430,224091
Jun,Week 26,2019,26111,4760,30871,227514
Jun,Week 26,2019,27966,4639,32605,227514
Jun,Week 26,2019,28695,4566,33261,227514
Jun,Week 26,2019,29317,4659,33976,227514
Jun,Week 26,2019,29649,4726,34375,227514
Jun,Week 26,2019,29117,4730,33847,227514
Jun,Week 26,2019,23601,4978,28579,227514
Jun,Week 27,2019,25280,4754,30034,203731
Jul,Week 27,2019,25917,4642,30559,203731
Jul,Week 27,2019,26630,4576,31206,203731
Jul,Week 27,2019,26614,4675,31289,203731
Jul,Week 27,2019,20159,4626,24785,203731
Jul,Week 27,2019,23355,4663,28018,203731
Jul,Week 27,2019,22840,5000,27840,203731
Jul,Week 28,2019,26861,4842,31703,227163
Jul,Week 28,2019,28406,4672,33078,227163
Jul,Week 28,2019,28787,4639,33426,227163
Jul,Week 28,2019,28978,4670,33648,227163
Jul,Week 28,2019,28290,4620,32910,227163
Jul,Week 28,2019,29073,4766,33839,227163
Jul,Week 28,2019,23450,5109,28559,227163
Jul,Week 29,2019,26653,4848,31501,227661
Jul,Week 29,2019,28285,4673,32958,227661
Jul,Week 29,2019,28885,4622,33507,227661
Jul,Week 29,2019,28682,4574,33256,227661
Jul,Week 29,2019,28773,4671,33444,227661
Jul,Week 29,2019,29208,4780,33988,227661
Jul,Week 29,2019,23865,5142,29007,227661
Jul,Week 30,2019,26517,4791,31308,228041
Jul,Week 30,2019,27541,4571,32112,228041
Jul,Week 30,2019,28802,4587,33389,228041
Jul,Week 30,2019,29340,4665,34005,228041
Jul,Week 30,2019,29665,4733,34398,228041
Jul,Week 30,2019,29105,4794,33899,228041
Jul,Week 30,2019,23773,5157,28930,228041
Jul,Week 31,2019,26755,4844,31599,227161
Jul,Week 31,2019,27873,4658,32531,227161
Jul,Week 31,2019,28767,4594,33361,227161
Jul,Week 31,2019,28308,4570,32878,227161
Aug,Week 31,2019,29399,4728,34127,227161
Aug,Week 31,2019,28930,4736,33666,227161
Aug,Week 31,2019,23865,5134,28999,227161
Aug,Week 32,2019,26791,4833,31624,226319
Aug,Week 32,2019,28337,4670,33007,226319
Aug,Week 32,2019,28660,4549,33209,226319
Aug,Week 32,2019,27821,4468,32289,226319
Aug,Week 32,2019,29244,4630,33874,226319
Aug,Week 32,2019,29076,4737,33813,226319
Aug,Week 32,2019,23453,5050,28503,226319
Aug,Week 33,2019,26717,4804,31521,225728
Aug,Week 33,2019,27871,4655,32526,225728
Aug,Week 33,2019,28491,4532,33023,225728
Aug,Week 33,2019,28796,4600,33396,225728
Aug,Week 33,2019,29182,4632,33814,225728
Aug,Week 33,2019,28812,4704,33516,225728
Aug,Week 33,2019,22968,4964,27932,225728
Aug,Week 34,2019,25609,4654,30263,219678
Aug,Week 34,2019,27553,4563,32116,219678
Aug,Week 34,2019,27193,4278,31471,219678
Aug,Week 34,2019,27969,4315,32284,219678
Aug,Week 34,2019,29124,4405,33529,219678
Aug,Week 34,2019,28606,4493,33099,219678
Aug,Week 34,2019,22313,4603,26916,219678
Aug,Week 35,2019,26163,4484,30647,218785
Aug,Week 35,2019,27572,4413,31985,218785
Aug,Week 35,2019,27558,4276,31834,218785
Aug,Week 35,2019,28185,4311,32496,218785
Aug,Week 35,2019,29224,4457,33681,218785
Aug,Week 35,2019,28665,4476,33141,218785
Aug,Week 35,2019,20525,4476,25001,218785
Sep,Week 36,2019,20318,4181,24499,199406
Sep,Week 36,2019,24641,3947,28588,199406
Sep,Week 36,2019,24625,3809,28434,199406
Sep,Week 36,2019,26181,4024,30205,199406
Sep,Week 36,2019,27229,4140,31369,199406
Sep,Week 36,2019,26960,4167,31127,199406
Sep,Week 36,2019,20955,4229,25184,199406
Sep,Week 37,2019,25726,4190,29916,214544
Sep,Week 37,2019,27095,4033,31128,214544
Sep,Week 37,2019,27378,3909,31287,214544
Sep,Week 37,2019,27526,4004,31530,214544
Sep,Week 37,2019,28588,4185,32773,214544
Sep,Week 37,2019,28257,4190,32447,214544
Sep,Week 37,2019,21216,4247,25463,214544
Sep,Week 38,2019,25854,4174,30028,213857
Sep,Week 38,2019,27205,4095,31300,213857
Sep,Week 38,2019,27294,3929,31223,213857
Sep,Week 38,2019,27660,3997,31657,213857
Sep,Week 38,2019,27748,3962,31710,213857
Sep,Week 38,2019,28234,4078,32312,213857
Sep,Week 38,2019,21459,4168,25627,213857
Sep,Week 39,2019,26083,4158,30241,214291
Sep,Week 39,2019,27156,4053,31209,214291
Sep,Week 39,2019,27131,3843,30974,214291
Sep,Week 39,2019,27650,4013,31663,214291
Sep,Week 39,2019,28953,4137,33090,214291
Sep,Week 39,2019,27414,4116,31530,214291
Sep,Week 39,2019,21390,4194,25584,214291
Sep,Week 40,2019,25763,4139,29902,215725
Sep,Week 40,2019,27191,4035,31226,215725
Oct,Week 40,2019,27258,3836,31094,215725
Oct,Week 40,2019,27780,4016,31796,215725
Oct,Week 40,2019,28965,4121,33086,215725
Oct,Week 40,2019,28528,4164,32692,215725
Oct,Week 40,2019,21720,4209,25929,215725
Oct,Week 41,2019,26136,4196,30332,216838
Oct,Week 41,2019,27299,4079,31378,216838
Oct,Week 41,2019,27502,3912,31414,216838
Oct,Week 41,2019,27871,4026,31897,216838
Oct,Week 41,2019,28875,4157,33032,216838
Oct,Week 41,2019,28500,4135,32635,216838
Oct,Week 41,2019,22015,4135,26150,216838
Oct,Week 42,2019,26248,4118,30366,218049
Oct,Week 42,2019,27761,4106,31867,218049
Oct,Week 42,2019,27791,3915,31706,218049
Oct,Week 42,2019,28140,4012,32152,218049
Oct,Week 42,2019,28775,4108,32883,218049
Oct,Week 42,2019,28735,4187,32922,218049
Oct,Week 42,2019,21917,4236,26153,218049
Oct,Week 43,2019,26236,4162,30398,216661
Oct,Week 43,2019,27401,4095,31496,216661
Oct,Week 43,2019,27785,3875,31660,216661
Oct,Week 43,2019,28058,3975,32033,216661
Oct,Week 43,2019,28823,4109,32932,216661
Oct,Week 43,2019,28438,4152,32590,216661
Oct,Week 43,2019,21404,4148,25552,216661
Oct,Week 44,2019,25408,4073,29481,204444
Oct,Week 44,2019,26433,3912,30345,204444
Oct,Week 44,2019,26249,3697,29946,204444
Oct,Week 44,2019,26496,3858,30354,204444
Oct,Week 44,2019,24273,3854,28127,204444
Nov,Week 44,2019,26721,3979,30700,204444
Nov,Week 44,2019,21293,4198,25491,204444
Nov,Week 45,2019,25768,4101,29869,213712
Nov,Week 45,2019,27204,3911,31115,213712
Nov,Week 45,2019,26805,3675,30480,213712
Nov,Week 45,2019,27317,3806,31123,213712
Nov,Week 45,2019,28918,3919,32837,213712
Nov,Week 45,2019,28521,4012,32533,213712
Nov,Week 45,2019,21499,4256,25755,213712
Nov,Week 46,2019,25831,4063,29894,213525
Nov,Week 46,2019,25798,3810,29608,213525
Nov,Week 46,2019,27301,3716,31017,213525
Nov,Week 46,2019,27922,3898,31820,213525
Nov,Week 46,2019,28855,4021,32876,213525
Nov,Week 46,2019,28548,4091,32639,213525
Nov,Week 46,2019,21419,4252,25671,213525
Nov,Week 47,2019,25892,4061,29953,218029
Nov,Week 47,2019,27408,3978,31386,218029
Nov,Week 47,2019,27594,3748,31342,218029
Nov,Week 47,2019,28022,3920,31942,218029
Nov,Week 47,2019,28778,4107,32885,218029
Nov,Week 47,2019,28773,4159,32932,218029
Nov,Week 47,2019,23235,4354,27589,218029
Nov,Week 48,2019,25256,4100,29356,198154
Nov,Week 48,2019,26069,3886,29955,198154
Nov,Week 48,2019,28039,3780,31819,198154
Nov,Week 48,2019,29071,3912,32983,198154
Nov,Week 48,2019,15732,3446,19178,198154
Nov,Week 48,2019,20388,3581,23969,198154
Nov,Week 48,2019,26570,4324,30894,198154
Dec,Week 49,2019,28053,4056,32109,217466
Dec,Week 49,2019,27459,3949,31408,217466
Dec,Week 49,2019,27761,3861,31622,217466
Dec,Week 49,2019,27862,3927,31789,217466
Dec,Week 49,2019,29122,4072,33194,217466
Dec,Week 49,2019,28211,4050,32261,217466
Dec,Week 49,2019,20720,4363,25083,217466
Dec,Week 50,2019,25369,4170,29539,214364
Dec,Week 50,2019,26785,4010,30795,214364
Dec,Week 50,2019,27303,3808,31111,214364
Dec,Week 50,2019,27880,3925,31805,214364
Dec,Week 50,2019,29134,4120,33254,214364
Dec,Week 50,2019,28411,4145,32556,214364
Dec,Week 50,2019,20925,4379,25304,214364
Dec,Week 51,2019,25080,4197,29277,222925
Dec,Week 51,2019,26792,4077,30869,222925
Dec,Week 51,2019,26948,3956,30904,222925
Dec,Week 51,2019,28197,4156,32353,222925
Dec,Week 51,2019,29419,4476,33895,222925
Dec,Week 51,2019,29447,4537,33984,222925
Dec,Week 51,2019,26631,5012,31643,222925
Dec,Week 52,2019,26907,4662,31569,208547
Dec,Week 52,2019,27514,4516,32030,208547
Dec,Week 52,2019,22554,4036,26590,208547
Dec,Week 52,2019,19751,3947,23698,208547
Dec,Week 52,2019,27817,4504,32321,208547
Dec,Week 52,2019,27861,4563,32424,208547
Dec,Week 52,2019,24966,4949,29915,208547
Jan,Week 2,2020,25662,4703,30365,207280
Jan,Week 2,2020,26580,4366,30946,207280
Jan,Week 2,2020,25643,4025,29668,207280
Jan,Week 2,2020,26350,4127,30477,207280
Jan,Week 2,2020,27649,4170,31819,207280
Jan,Week 2,2020,26394,4194,30588,207280
Jan,Week 2,2020,18945,4472,23417,207280
Jan,Week 3,2020,24565,4166,28731,204001
Jan,Week 3,2020,25921,4045,29966,204001
Jan,Week 3,2020,25675,3793,29468,204001
Jan,Week 3,2020,26423,3955,30378,204001
Jan,Week 3,2020,27648,4101,31749,204001
Jan,Week 3,2020,26086,4163,30249,204001
Jan,Week 3,2020,19122,4338,23460,204001
Jan,Week 4,2020,22271,4150,26421,203842
Jan,Week 4,2020,26133,4074,30207,203842
Jan,Week 4,2020,25749,3760,29509,203842
Jan,Week 4,2020,26357,3921,30278,203842
Jan,Week 4,2020,27659,4076,31735,203842
Jan,Week 4,2020,27029,4131,31160,203842
Jan,Week 4,2020,20116,4416,24532,203842
Jan,Week 5,2020,24713,4190,28903,206354
Jan,Week 5,2020,26037,3998,30035,206354
Jan,Week 5,2020,25776,3665,29441,206354
Jan,Week 5,2020,26344,3883,30227,206354
Jan,Week 5,2020,27848,4075,31923,206354
Jan,Week 5,2020,27326,4150,31476,206354
Feb,Week 5,2020,19950,4399,24349,206354
Feb,Week 6,2020,23223,4100,27323,202285
Feb,Week 6,2020,26385,3963,30348,202285
Feb,Week 6,2020,25728,3604,29332,202285
Feb,Week 6,2020,26088,3818,29906,202285
Feb,Week 6,2020,26800,3910,30710,202285
Feb,Week 6,2020,26262,3915,30177,202285
Feb,Week 6,2020,20189,4300,24489,202285
Feb,Week 7,2020,24180,3970,28150,208741
Feb,Week 7,2020,26206,3871,30077,208741
Feb,Week 7,2020,25835,3647,29482,208741
Feb,Week 7,2020,26717,3841,30558,208741
Feb,Week 7,2020,28266,4002,32268,208741
Feb,Week 7,2020,28150,4181,32331,208741
Feb,Week 7,2020,21321,4554,25875,208741
Feb,Week 8,2020,23373,4167,27540,211826
Feb,Week 8,2020,27008,4067,31075,211826
Feb,Week 8,2020,27369,3793,31162,211826
Feb,Week 8,2020,27636,3966,31602,211826
Feb,Week 8,2020,28062,4105,32167,211826
Feb,Week 8,2020,27777,4161,31938,211826
Feb,Week 8,2020,21741,4601,26342,211826
Feb,Week 9,2020,25466,4247,29713,213711
Feb,Week 9,2020,26894,4069,30963,213711
Feb,Week 9,2020,27188,3847,31035,213711
Feb,Week 9,2020,27558,3950,31508,213711
Feb,Week 9,2020,28249,3952,32201,213711
Feb,Week 9,2020,27927,4177,32104,213711
Feb,Week 9,2020,21617,4570,26187,213711
Mar,Week 10,2020,25436,4253,29689,215990
Mar,Week 10,2020,26999,4077,31076,215990
Mar,Week 10,2020,27195,3892,31087,215990
Mar,Week 10,2020,27658,4003,31661,215990
Mar,Week 10,2020,28446,4157,32603,215990
Mar,Week 10,2020,28206,4248,32454,215990
Mar,Week 10,2020,22723,4697,27420,215990
Mar,Week 11,2020,25778,4293,30071,218346
Mar,Week 11,2020,27268,4059,31327,218346
Mar,Week 11,2020,27414,3912,31326,218346
Mar,Week 11,2020,27865,4004,31869,218346
Mar,Week 11,2020,29065,4124,33189,218346
Mar,Week 11,2020,28541,4161,32702,218346
Mar,Week 11,2020,23342,4520,27862,218346
Mar,Week 12,2020,25943,4019,29962,194037
Mar,Week 12,2020,27234,3600,30834,194037
Mar,Week 12,2020,26727,3197,29924,194037
Mar,Week 12,2020,25701,3121,28822,194037
Mar,Week 12,2020,24129,3003,27132,194037
Mar,Week 12,2020,23223,2786,26009,194037
Mar,Week 12,2020,18455,2899,21354,194037
Mar,Week 13,2020,18805,2284,21089,123367
Mar,Week 13,2020,17954,1597,19551,123367
Mar,Week 13,2020,17963,1305,19268,123367
Mar,Week 13,2020,16601,1164,17765,123367
Mar,Week 13,2020,16048,1003,17051,123367
Mar,Week 13,2020,14515,895,15410,123367
Mar,Week 13,2020,12390,843,13233,123367
Mar,Week 14,2020,13077,680,13757,90957
Mar,Week 14,2020,13030,624,13654,90957
Mar,Week 14,2020,13773,626,14399,90957
Apr,Week 14,2020,13147,571,13718,90957
Apr,Week 14,2020,12149,534,12683,90957
Apr,Week 14,2020,12040,558,12598,90957
Apr,Week 14,2020,9625,523,10148,90957
Apr,Week 15,2020,10045,510,10555,74844
Apr,Week 15,2020,10475,471,10946,74844
Apr,Week 15,2020,10795,432,11227,74844
Apr,Week 15,2020,10942,452,11394,74844
Apr,Week 15,2020,10956,431,11387,74844
Apr,Week 15,2020,10357,407,10764,74844
Apr,Week 15,2020,8178,393,8571,74844
Apr,Week 16,2020,7924,362,8286,63156
Apr,Week 16,2020,9113,394,9507,63156
Apr,Week 16,2020,9596,387,9983,63156
Apr,Week 16,2020,9402,396,9798,63156
Apr,Week 16,2020,8947,399,9346,63156
Apr,Week 16,2020,8665,405,9070,63156
Apr,Week 16,2020,6814,352,7166,63156
Apr,Week 17,2020,6824,332,7156,58113
Apr,Week 17,2020,7560,326,7886,58113
Apr,Week 17,2020,8399,348,8747,58113
Apr,Week 17,2020,8614,399,9013,58113
Apr,Week 17,2020,8861,415,9276,58113
Apr,Week 17,2020,8550,411,8961,58113
Apr,Week 17,2020,6679,395,7074,58113
Apr,Week 18,2020,6860,355,7215,59588
Apr,Week 18,2020,7657,332,7989,59588
Apr,Week 18,2020,8515,342,8857,59588
Apr,Week 18,2020,8687,409,9096,59588
Apr,Week 18,2020,9098,415,9513,59588
May,Week 18,2020,9338,426,9764,59588
May,Week 18,2020,6801,353,7154,59588
May,Week 19,2020,7737,330,8067,62760
May,Week 19,2020,8466,342,8808,62760
May,Week 19,2020,8635,349,8984,62760
May,Week 19,2020,9025,388,9413,62760
May,Week 19,2020,9582,432,10014,62760
May,Week 19,2020,9534,423,9957,62760
May,Week 19,2020,7150,367,7517,62760
May,Week 20,2020,7629,376,8005,63673
May,Week 20,2020,8548,378,8926,63673
May,Week 20,2020,8634,364,8998,63673
May,Week 20,2020,9302,430,9732,63673
May,Week 20,2020,9855,441,10296,63673
May,Week 20,2020,9612,427,10039,63673
May,Week 20,2020,7288,389,7677,63673
May,Week 21,2020,7946,382,8328,66940
May,Week 21,2020,8867,359,9226,66940
May,Week 21,2020,8920,357,9277,66940
May,Week 21,2020,9811,456,10267,66940
May,Week 21,2020,10507,459,10966,66940
May,Week 21,2020,10316,436,10752,66940
May,Week 21,2020,7730,394,8124,66940
May,Week 22,2020,8045,395,8440,66293
May,Week 22,2020,8282,394,8676,66293
May,Week 22,2020,8497,385,8882,66293
May,Week 22,2020,10013,447,10460,66293
May,Week 22,2020,10562,461,11023,66293
May,Week 22,2020,10196,440,10636,66293
May,Week 22,2020,7789,387,8176,66293
May,Week 23,2020,8744,388,9132,73770
Jun,Week 23,2020,9739,439,10178,73770
Jun,Week 23,2020,9755,418,10173,73770
Jun,Week 23,2020,10501,493,10994,73770
Jun,Week 23,2020,11489,535,12024,73770
Jun,Week 23,2020,11271,534,11805,73770
Jun,Week 23,2020,8952,512,9464,73770
Jun,Week 24,2020,10086,490,10576,82188
Jun,Week 24,2020,10958,472,11430,82188
Jun,Week 24,2020,11083,471,11554,82188
Jun,Week 24,2020,11533,533,12066,82188
Jun,Week 24,2020,12691,556,13247,82188
Jun,Week 24,2020,12313,552,12865,82188
Jun,Week 24,2020,9940,510,10450,82188
Jun,Week 25,2020,10948,490,11438,86396
Jun,Week 25,2020,11690,507,12197,86396
Jun,Week 25,2020,11449,524,11973,86396
Jun,Week 25,2020,11871,563,12434,86396
Jun,Week 25,2020,13223,617,13840,86396
Jun,Week 25,2020,12797,611,13408,86396
Jun,Week 25,2020,10523,583,11106,86396
Jun,Week 26,2020,11281,538,11819,90736
Jun,Week 26,2020,12433,557,12990,90736
Jun,Week 26,2020,12128,555,12683,90736
Jun,Week 26,2020,12506,611,13117,90736
Jun,Week 26,2020,13770,653,14423,90736
Jun,Week 26,2020,13407,655,14062,90736
Jun,Week 26,2020,11025,617,11642,90736
Jun,Week 27,2020,11824,577,12401,96108
Jun,Week 27,2020,12666,571,13237,96108
Jun,Week 27,2020,12740,554,13294,96108
Jul,Week 27,2020,13887,789,14676,96108
Jul,Week 27,2020,15527,870,16397,96108
Jul,Week 27,2020,14320,898,15218,96108
Jul,Week 27,2020,10052,833,10885,96108
Jul,Week 28,2020,13377,804,14181,115224
Jul,Week 28,2020,14828,823,15651,115224
Jul,Week 28,2020,15452,842,16294,115224
Jul,Week 28,2020,15859,932,16791,115224
Jul,Week 28,2020,17520,1000,18520,115224
Jul,Week 28,2020,17027,1013,18040,115224
Jul,Week 28,2020,14732,1015,15747,115224
Jul,Week 29,2020,15717,936,16653,119691
Jul,Week 29,2020,16178,907,17085,119691
Jul,Week 29,2020,15392,866,16258,119691
Jul,Week 29,2020,15940,981,16921,119691
Jul,Week 29,2020,17465,1026,18491,119691
Jul,Week 29,2020,17240,1061,18301,119691
Jul,Week 29,2020,14928,1054,15982,119691
Jul,Week 30,2020,15644,987,16631,119784
Jul,Week 30,2020,16359,938,17297,119784
Jul,Week 30,2020,15463,874,16337,119784
Jul,Week 30,2020,15865,954,16819,119784
Jul,Week 30,2020,17484,1032,18516,119784
Jul,Week 30,2020,17278,1040,18318,119784
Jul,Week 30,2020,14850,1016,15866,119784
Jul,Week 31,2020,15280,971,16251,118703
Jul,Week 31,2020,16174,924,17098,118703
Jul,Week 31,2020,15367,845,16212,118703
Jul,Week 31,2020,15636,939,16575,118703
Jul,Week 31,2020,17219,944,18163,118703
Jul,Week 31,2020,17139,1001,18140,118703
Aug,Week 31,2020,15218,1046,16264,118703
Aug,Week 32,2020,15988,1048,17036,122863
Aug,Week 32,2020,16889,1021,17910,122863
Aug,Week 32,2020,15168,867,16035,122863
Aug,Week 32,2020,16216,1018,17234,122863
Aug,Week 32,2020,18105,1068,19173,122863
Aug,Week 32,2020,17782,1124,18906,122863
Aug,Week 32,2020,15439,1130,16569,122863
Aug,Week 33,2020,16298,1071,17369,123823
Aug,Week 33,2020,16870,1018,17888,123823
Aug,Week 33,2020,15858,869,16727,123823
Aug,Week 33,2020,16333,995,17328,123823
Aug,Week 33,2020,18157,1045,19202,123823
Aug,Week 33,2020,17679,1103,18782,123823
Aug,Week 33,2020,15397,1130,16527,123823
Aug,Week 34,2020,16406,1074,17480,122755
Aug,Week 34,2020,16710,998,17708,122755
Aug,Week 34,2020,15725,880,16605,122755
Aug,Week 34,2020,16055,993,17048,122755
Aug,Week 34,2020,18132,1084,19216,122755
Aug,Week 34,2020,17483,1093,18576,122755
Aug,Week 34,2020,14992,1130,16122,122755
Aug,Week 35,2020,16240,1074,17314,121323
Aug,Week 35,2020,16586,985,17571,121323
Aug,Week 35,2020,15767,896,16663,121323
Aug,Week 35,2020,15492,970,16462,121323
Aug,Week 35,2020,17691,1004,18695,121323
Aug,Week 35,2020,17483,1073,18556,121323
Aug,Week 35,2020,14907,1155,16062,121323
Aug,Week 36,2020,16089,1053,17142,121676
Aug,Week 36,2020,16608,1014,17622,121676
Sep,Week 36,2020,15634,909,16543,121676
Sep,Week 36,2020,15924,1019,16943,121676
Sep,Week 36,2020,18364,1110,19474,121676
Sep,Week 36,2020,17837,1132,18969,121676
Sep,Week 36,2020,13864,1119,14983,121676
Sep,Week 37,2020,13276,1048,14324,112016
Sep,Week 37,2020,15366,1008,16374,112016
Sep,Week 37,2020,14167,915,15082,112016
Sep,Week 37,2020,15166,991,16157,112016
Sep,Week 37,2020,16698,1152,17850,112016
Sep,Week 37,2020,16257,1162,17419,112016
Sep,Week 37,2020,13553,1257,14810,112016
Sep,Week 38,2020,14729,1157,15886,113244
Sep,Week 38,2020,14938,1047,15985,113244
Sep,Week 38,2020,14176,906,15082,113244
Sep,Week 38,2020,15042,1015,16057,113244
Sep,Week 38,2020,16652,1188,17840,113244
Sep,Week 38,2020,16351,1195,17546,113244
Sep,Week 38,2020,13619,1229,14848,113244
Sep,Week 39,2020,14934,1188,16122,115052
Sep,Week 39,2020,15118,1090,16208,115052
Sep,Week 39,2020,14520,949,15469,115052
Sep,Week 39,2020,15376,1052,16428,115052
Sep,Week 39,2020,16947,1225,18172,115052
Sep,Week 39,2020,16441,1221,17662,115052
Sep,Week 39,2020,13714,1277,14991,115052
Sep,Week 40,2020,15030,1209,16239,117342
Sep,Week 40,2020,15260,1087,16347,117342
Sep,Week 40,2020,14783,923,15706,117342
Sep,Week 40,2020,15374,1067,16441,117342
Oct,Week 40,2020,17488,1278,18766,117342
Oct,Week 40,2020,17031,1291,18322,117342
Oct,Week 40,2020,14211,1310,15521,117342
Oct,Week 41,2020,15646,1279,16925,120703
Oct,Week 41,2020,15926,1168,17094,120703
Oct,Week 41,2020,14675,1001,15676,120703
Oct,Week 41,2020,15240,1052,16292,120703
Oct,Week 41,2020,18165,1312,19477,120703
Oct,Week 41,2020,17768,1399,19167,120703
Oct,Week 41,2020,14625,1447,16072,120703
Oct,Week 42,2020,16249,1349,17598,123817
Oct,Week 42,2020,16753,1278,18031,123817
Oct,Week 42,2020,15100,1073,16173,123817
Oct,Week 42,2020,15663,1218,16881,123817
Oct,Week 42,2020,18222,1374,19596,123817
Oct,Week 42,2020,17878,1430,19308,123817
Oct,Week 42,2020,14732,1498,16230,123817
Oct,Week 43,2020,16747,1399,18146,123614
Oct,Week 43,2020,16697,1305,18002,123614
Oct,Week 43,2020,15131,1086,16217,123614
Oct,Week 43,2020,15598,1210,16808,123614
Oct,Week 43,2020,18071,1398,19469,123614
Oct,Week 43,2020,17755,1423,19178,123614
Oct,Week 43,2020,14315,1479,15794,123614
Oct,Week 44,2020,15611,1398,17009,117488
Oct,Week 44,2020,15850,1285,17135,117488
Oct,Week 44,2020,14730,1103,15833,117488
Oct,Week 44,2020,15243,1251,16494,117488
Oct,Week 44,2020,17407,1393,18800,117488
Oct,Week 44,2020,17176,1437,18613,117488
Oct,Week 44,2020,12219,1385,13604,117488
Nov,Week 45,2020,15133,1497,16630,120741
Nov,Week 45,2020,15904,1410,17314,120741
Nov,Week 45,2020,13952,1224,15176,120741
Nov,Week 45,2020,15089,1478,16567,120741
Nov,Week 45,2020,18151,1553,19704,120741
Nov,Week 45,2020,17764,1600,19364,120741
Nov,Week 45,2020,14268,1718,15986,120741
Nov,Week 46,2020,16695,1619,18314,126264
Nov,Week 46,2020,16900,1476,18376,126264
Nov,Week 46,2020,14881,1302,16183,126264
Nov,Week 46,2020,15507,1527,17034,126264
Nov,Week 46,2020,18515,1610,20125,126264
Nov,Week 46,2020,18170,1613,19783,126264
Nov,Week 46,2020,14699,1750,16449,126264
Nov,Week 47,2020,16895,1651,18546,132552
Nov,Week 47,2020,17177,1515,18692,132552
Nov,Week 47,2020,14978,1282,16260,132552
Nov,Week 47,2020,16071,1539,17610,132552
Nov,Week 47,2020,19116,1677,20793,132552
Nov,Week 47,2020,19529,1748,21277,132552
Nov,Week 47,2020,17440,1934,19374,132552
Nov,Week 48,2020,18046,1753,19799,130306
Nov,Week 48,2020,17193,1540,18733,130306
Nov,Week 48,2020,19997,1535,21532,130306
Nov,Week 48,2020,19979,1685,21664,130306
Nov,Week 48,2020,9355,1363,10718,130306
Nov,Week 48,2020,15825,1632,17457,130306
Nov,Week 48,2020,18482,1921,20403,130306
Nov,Week 49,2020,19810,1768,21578,133759
Nov,Week 49,2020,19263,1665,20928,133759
Dec,Week 49,2020,17901,1467,19368,133759
Dec,Week 49,2020,15779,1693,17472,133759
Dec,Week 49,2020,17896,1750,19646,133759
Dec,Week 49,2020,17441,1797,19238,133759
Dec,Week 49,2020,13581,1948,15529,133759
Dec,Week 50,2020,15776,1833,17609,124142
Dec,Week 50,2020,16311,1736,18047,124142
Dec,Week 50,2020,14914,1456,16370,124142
Dec,Week 50,2020,15541,1746,17287,124142
Dec,Week 50,2020,18015,1812,19827,124142
Dec,Week 50,2020,17477,1886,19363,124142
Dec,Week 50,2020,13625,2014,15639,124142
Dec,Week 51,2020,15858,1849,17707,136100
Dec,Week 51,2020,16421,1759,18180,136100
Dec,Week 51,2020,15515,1534,17049,136100
Dec,Week 51,2020,15508,1754,17262,136100
Dec,Week 51,2020,18919,1961,20880,136100
Dec,Week 51,2020,20713,2261,22974,136100
Dec,Week 51,2020,19503,2545,22048,136100
Dec,Week 52,2020,18771,2290,21061,137512
Dec,Week 52,2020,19179,2084,21263,137512
Dec,Week 52,2020,20230,2076,22306,137512
Dec,Week 52,2020,20644,2198,22842,137512
Dec,Week 52,2020,15039,1798,16837,137512
Dec,Week 52,2020,10979,1673,12652,137512
Dec,Week 52,2020,18182,2369,20551,137512
Jan,Week 2,2021,19113,2300,21413,132627
Jan,Week 2,2021,18435,2151,20586,132627
Jan,Week 2,2021,16158,1821,17979,132627
Jan,Week 2,2021,15909,1877,17786,132627
Jan,Week 2,2021,17609,1972,19581,132627
Jan,Week 2,2021,17123,2047,19170,132627
Jan,Week 2,2021,13845,2267,16112,132627
Jan,Week 3,2021,15428,2092,17520,123755
Jan,Week 3,2021,15853,1888,17741,123755
Jan,Week 3,2021,14936,1662,16598,123755
Jan,Week 3,2021,15280,1778,17058,123755
Jan,Week 3,2021,17726,1899,19625,123755
Jan,Week 3,2021,17441,1999,19440,123755
Jan,Week 3,2021,13566,2207,15773,123755
Jan,Week 4,2021,14959,1986,16945,122918
Jan,Week 4,2021,16241,1853,18094,122918
Jan,Week 4,2021,14914,1603,16517,122918
Jan,Week 4,2021,15281,1747,17028,122918
Jan,Week 4,2021,17606,1882,19488,122918
Jan,Week 4,2021,17198,1941,19139,122918
Jan,Week 4,2021,13538,2169,15707,122918
Jan,Week 5,2021,15810,1985,17795,122407
Jan,Week 5,2021,15618,1804,17422,122407
Jan,Week 5,2021,14501,1543,16044,122407
Jan,Week 5,2021,15291,1672,16963,122407
Jan,Week 5,2021,17396,1821,19217,122407
Jan,Week 5,2021,17367,1914,19281,122407
Jan,Week 5,2021,13556,2129,15685,122407
Jan,Week 6,2021,15285,1929,17214,120516
Feb,Week 6,2021,14339,1516,15855,120516
Feb,Week 6,2021,14275,1479,15754,120516
Feb,Week 6,2021,15403,1664,17067,120516
Feb,Week 6,2021,17569,1821,19390,120516
Feb,Week 6,2021,17406,1883,19289,120516
Feb,Week 6,2021,13836,2111,15947,120516
Feb,Week 7,2021,14962,1845,16807,125972
Feb,Week 7,2021,16553,1692,18245,125972
Feb,Week 7,2021,15056,1484,16540,125972
Feb,Week 7,2021,15666,1632,17298,125972
Feb,Week 7,2021,18244,1888,20132,125972
Feb,Week 7,2021,18645,2003,20648,125972
Feb,Week 7,2021,14115,2187,16302,125972
Feb,Week 8,2021,13550,1807,15357,112236
Feb,Week 8,2021,13386,1549,14935,112236
Feb,Week 8,2021,12430,1386,13816,112236
Feb,Week 8,2021,13534,1518,15052,112236
Feb,Week 8,2021,15181,1693,16874,112236
Feb,Week 8,2021,17197,1831,19028,112236
Feb,Week 8,2021,14972,2202,17174,112236
Feb,Week 9,2021,17188,1943,19131,132437
Feb,Week 9,2021,17355,1723,19078,132437
Feb,Week 9,2021,15987,1550,17537,132437
Feb,Week 9,2021,16507,1670,18177,132437
Feb,Week 9,2021,18952,1830,20782,132437
Feb,Week 9,2021,18768,1889,20657,132437
Feb,Week 9,2021,14923,2152,17075,132437
Feb,Week 10,2021,17384,1952,19336,136862
Mar,Week 10,2021,17500,1744,19244,136862
Mar,Week 10,2021,16089,1547,17636,136862
Mar,Week 10,2021,16810,1680,18490,136862
Mar,Week 10,2021,20017,1823,21840,136862
Mar,Week 10,2021,19724,1921,21645,136862
Mar,Week 10,2021,16493,2178,18671,136862
Mar,Week 11,2021,18895,1982,20877,148145
Mar,Week 11,2021,19352,1779,21131,148145
Mar,Week 11,2021,17735,1652,19387,148145
Mar,Week 11,2021,18375,1787,20162,148145
Mar,Week 11,2021,21494,1911,23405,148145
Mar,Week 11,2021,21378,2003,23381,148145
Mar,Week 11,2021,17569,2233,19802,148145
Mar,Week 12,2021,17932,1978,19910,150377
Mar,Week 12,2021,19090,1808,20898,150377
Mar,Week 12,2021,19101,1706,20807,150377
Mar,Week 12,2021,19168,1823,20991,150377
Mar,Week 12,2021,21574,1922,23496,150377
Mar,Week 12,2021,21405,1992,23397,150377
Mar,Week 12,2021,18614,2264,20878,150377
Mar,Week 13,2021,20043,2055,22098,155599
Mar,Week 13,2021,20166,1812,21978,155599
Mar,Week 13,2021,19244,1677,20921,155599
Mar,Week 13,2021,19868,1842,21710,155599
Mar,Week 13,2021,22095,1975,24070,155599
Mar,Week 13,2021,21614,2035,23649,155599
Mar,Week 13,2021,18861,2312,21173,155599
Mar,Week 14,2021,19956,2094,22050,156139
Mar,Week 14,2021,20234,1870,22104,156139
Mar,Week 14,2021,19361,1780,21141,156139
Mar,Week 14,2021,20043,1894,21937,156139
Apr,Week 14,2021,22079,1946,24025,156139
Apr,Week 14,2021,21826,2019,23845,156139
Apr,Week 14,2021,18766,2271,21037,156139
Apr,Week 15,2021,19923,2090,22013,157161
Apr,Week 15,2021,21184,1892,23076,157161
Apr,Week 15,2021,19466,1800,21266,157161
Apr,Week 15,2021,19845,1882,21727,157161
Apr,Week 15,2021,22295,1958,24253,157161
Apr,Week 15,2021,21837,2045,23882,157161
Apr,Week 15,2021,18652,2292,20944,157161
Apr,Week 16,2021,19487,2041,21528,153121
Apr,Week 16,2021,20643,1887,22530,153121
Apr,Week 16,2021,18854,1754,20608,153121
Apr,Week 16,2021,19144,1876,21020,153121
Apr,Week 16,2021,21882,1941,23823,153121
Apr,Week 16,2021,21431,2020,23451,153121
Apr,Week 16,2021,17905,2256,20161,153121
Apr,Week 17,2021,20037,2082,22119,153692
Apr,Week 17,2021,20203,1881,22084,153692
Apr,Week 17,2021,18746,1778,20524,153692
Apr,Week 17,2021,19173,1884,21057,153692
Apr,Week 17,2021,22171,1977,24148,153692
Apr,Week 17,2021,21495,2061,23556,153692
Apr,Week 17,2021,17928,2276,20204,153692
Apr,Week 18,2021,20205,2095,22300,154357
Apr,Week 18,2021,20313,1900,22213,154357
Apr,Week 18,2021,18777,1795,20572,154357
Apr,Week 18,2021,19173,1877,21050,154357
Apr,Week 18,2021,22171,1981,24152,154357
Apr,Week 18,2021,21596,2088,23684,154357
May,Week 18,2021,18033,2353,20386,154357
May,Week 19,2021,20182,2093,22275,157895
May,Week 19,2021,20378,1926,22304,157895
May,Week 19,2021,18640,1852,20492,157895
May,Week 19,2021,19650,1950,21600,157895
May,Week 19,2021,22926,2103,25029,157895
May,Week 19,2021,22572,2180,24752,157895
May,Week 19,2021,19060,2383,21443,157895
May,Week 20,2021,20890,2181,23071,164025
May,Week 20,2021,21509,2027,23536,164025
May,Week 20,2021,20140,1941,22081,164025
May,Week 20,2021,21146,2049,23195,164025
May,Week 20,2021,23396,2134,25530,164025
May,Week 20,2021,22890,2188,25078,164025
May,Week 20,2021,19121,2413,21534,164025
May,Week 21,2021,21203,2186,23389,166259
May,Week 21,2021,21748,2045,23793,166259
May,Week 21,2021,20785,1969,22754,166259
May,Week 21,2021,21510,2050,23560,166259
May,Week 21,2021,23580,2164,25744,166259
May,Week 21,2021,23070,2212,25282,166259
May,Week 21,2021,19308,2429,21737,166259
May,Week 22,2021,21429,2218,23647,168482
May,Week 22,2021,22014,2064,24078,168482
May,Week 22,2021,21040,2014,23054,168482
May,Week 22,2021,21970,2085,24055,168482
May,Week 22,2021,23897,2194,26091,168482
May,Week 22,2021,23545,2247,25792,168482
May,Week 22,2021,19281,2484,21765,168482
May,Week 23,2021,19923,2255,22178,170883
May,Week 23,2021,21326,2127,23453,170883
Jun,Week 23,2021,20974,2125,23099,170883
Jun,Week 23,2021,22303,2220,24523,170883
Jun,Week 23,2021,24304,2409,26713,170883
Jun,Week 23,2021,24494,2444,26938,170883
Jun,Week 23,2021,21250,2729,23979,170883
Jun,Week 24,2021,23121,2477,25598,183657
Jun,Week 24,2021,23510,2353,25863,183657
Jun,Week 24,2021,23299,2284,25583,183657
Jun,Week 24,2021,23915,2402,26317,183657
Jun,Week 24,2021,25545,2448,27993,183657
Jun,Week 24,2021,25194,2518,27712,183657
Jun,Week 24,2021,21812,2779,24591,183657
Jun,Week 25,2021,23353,2547,25900,185164
Jun,Week 25,2021,23915,2396,26311,185164
Jun,Week 25,2021,23254,2376,25630,185164
Jun,Week 25,2021,24194,2480,26674,185164
Jun,Week 25,2021,25700,2547,28247,185164
Jun,Week 25,2021,25089,2561,27650,185164
Jun,Week 25,2021,21931,2821,24752,185164
Jun,Week 26,2021,23327,2559,25886,186039
Jun,Week 26,2021,23624,2440,26064,186039
Jun,Week 26,2021,23889,2425,26314,186039
Jun,Week 26,2021,24561,2536,27097,186039
Jun,Week 26,2021,25598,2579,28177,186039
Jun,Week 26,2021,25330,2600,27930,186039
Jun,Week 26,2021,21675,2896,24571,186039
Jun,Week 27,2021,23439,2598,26037,186910
Jun,Week 27,2021,23896,2474,26370,186910
Jun,Week 27,2021,23851,2424,26275,186910
Jun,Week 27,2021,24630,2522,27152,186910
Jul,Week 27,2021,26123,2584,28707,186910
Jul,Week 27,2021,25184,2619,27803,186910
Jul,Week 27,2021,21642,2924,24566,186910
Jul,Week 28,2021,20147,2657,22804,183915
Jul,Week 28,2021,23341,2604,25945,183915
Jul,Week 28,2021,23227,2521,25748,183915
Jul,Week 28,2021,24605,2574,27179,183915
Jul,Week 28,2021,25944,2643,28587,183915
Jul,Week 28,2021,25323,2686,28009,183915
Jul,Week 28,2021,22644,2999,25643,183915
Jul,Week 29,2021,24024,2701,26725,190712
Jul,Week 29,2021,24496,2563,27059,190712
Jul,Week 29,2021,24365,2554,26919,190712
Jul,Week 29,2021,24942,2626,27568,190712
Jul,Week 29,2021,26227,2692,28919,190712
Jul,Week 29,2021,25739,2766,28505,190712
Jul,Week 29,2021,22038,2979,25017,190712
Jul,Week 30,2021,24014,2714,26728,191934
Jul,Week 30,2021,24644,2614,27258,191934
Jul,Week 30,2021,24718,2568,27286,191934
Jul,Week 30,2021,25035,2615,27650,191934
Jul,Week 30,2021,26427,2723,29150,191934
Jul,Week 30,2021,25672,2762,28434,191934
Jul,Week 30,2021,22394,3034,25428,191934
Jul,Week 31,2021,24078,2721,26799,191752
Jul,Week 31,2021,24699,2618,27317,191752
Jul,Week 31,2021,24572,2564,27136,191752
Jul,Week 31,2021,25147,2643,27790,191752
Jul,Week 31,2021,26253,2706,28959,191752
Jul,Week 31,2021,25763,2750,28513,191752
Jul,Week 31,2021,22277,2961,25238,191752
Aug,Week 32,2021,23535,2775,26310,187931
Aug,Week 32,2021,23787,2593,26380,187931
Aug,Week 32,2021,23652,2574,26226,187931
Aug,Week 32,2021,24415,2705,27120,187931
Aug,Week 32,2021,25780,2768,28548,187931
Aug,Week 32,2021,25286,2827,28113,187931
Aug,Week 32,2021,22117,3117,25234,187931
Aug,Week 33,2021,23992,2842,26834,189248
Aug,Week 33,2021,24016,2690,26706,189248
Aug,Week 33,2021,23984,2665,26649,189248
Aug,Week 33,2021,24295,2675,26970,189248
Aug,Week 33,2021,26071,2772,28843,189248
Aug,Week 33,2021,25612,2788,28400,189248
Aug,Week 33,2021,21788,3058,24846,189248
Aug,Week 34,2021,23523,2765,26288,186833
Aug,Week 34,2021,24518,2652,27170,186833
Aug,Week 34,2021,23021,2429,25450,186833
Aug,Week 34,2021,24010,2543,26553,186833
Aug,Week 34,2021,26092,2608,28700,186833
Aug,Week 34,2021,25323,2682,28005,186833
Aug,Week 34,2021,21737,2930,24667,186833
Aug,Week 35,2021,22591,2631,25222,185429
Aug,Week 35,2021,23958,2561,26519,185429
Aug,Week 35,2021,23378,2483,25861,185429
Aug,Week 35,2021,24096,2569,26665,185429
Aug,Week 35,2021,25902,2634,28536,185429
Aug,Week 35,2021,25529,2679,28208,185429
Aug,Week 35,2021,21507,2911,24418,185429
Aug,Week 36,2021,23276,2683,25959,183355
Aug,Week 36,2021,23219,2562,25781,183355
Aug,Week 36,2021,23073,2510,25583,183355
Sep,Week 36,2021,23498,2480,25978,183355
Sep,Week 36,2021,25473,2574,28047,183355
Sep,Week 36,2021,25609,2706,28315,183355
Sep,Week 36,2021,20789,2903,23692,183355
Sep,Week 37,2021,20776,2668,23444,177893
Sep,Week 37,2021,22619,2546,25165,177893
Sep,Week 37,2021,21982,2448,24430,177893
Sep,Week 37,2021,23089,2436,25525,177893
Sep,Week 37,2021,25643,2569,28212,177893
Sep,Week 37,2021,25204,2611,27815,177893
Sep,Week 37,2021,20446,2856,23302,177893
Sep,Week 38,2021,23787,2670,26457,183275
Sep,Week 38,2021,23622,2502,26124,183275
Sep,Week 38,2021,22462,2331,24793,183275
Sep,Week 38,2021,23446,2420,25866,183275
Sep,Week 38,2021,26009,2528,28537,183275
Sep,Week 38,2021,25588,2615,28203,183275
Sep,Week 38,2021,20458,2837,23295,183275
Sep,Week 39,2021,24068,2693,26761,184106
Sep,Week 39,2021,23943,2495,26438,184106
Sep,Week 39,2021,22788,2372,25160,184106
Sep,Week 39,2021,23342,2455,25797,184106
Sep,Week 39,2021,25659,2520,28179,184106
Sep,Week 39,2021,25758,2625,28383,184106
Sep,Week 39,2021,20567,2821,23388,184106
Sep,Week 40,2021,24249,2700,26949,184461
Sep,Week 40,2021,24078,2460,26538,184461
Sep,Week 40,2021,22661,2346,25007,184461
Sep,Week 40,2021,23458,2453,25911,184461
Sep,Week 40,2021,26015,2589,28604,184461
Oct,Week 40,2021,25482,2609,28091,184461
Oct,Week 40,2021,20530,2831,23361,184461
Oct,Week 41,2021,24117,2666,26783,185505
Oct,Week 41,2021,23981,2468,26449,185505
Oct,Week 41,2021,22914,2352,25266,185505
Oct,Week 41,2021,23773,2472,26245,185505
Oct,Week 41,2021,26260,2655,28915,185505
Oct,Week 41,2021,25666,2708,28374,185505
Oct,Week 41,2021,20584,2889,23473,185505
Oct,Week 42,2021,22806,2702,25508,186312
Oct,Week 42,2021,23972,2588,26560,186312
Oct,Week 42,2021,23696,2488,26184,186312
Oct,Week 42,2021,23932,2557,26489,186312
Oct,Week 42,2021,26244,2687,28931,186312
Oct,Week 42,2021,25789,2729,28518,186312
Oct,Week 42,2021,21190,2932,24122,186312
Oct,Week 43,2021,24014,2758,26772,186275
Oct,Week 43,2021,24479,2595,27074,186275
Oct,Week 43,2021,23595,2492,26087,186275
Oct,Week 43,2021,24374,2578,26952,186275
Oct,Week 43,2021,25534,2684,28218,186275
Oct,Week 43,2021,24606,2527,27133,186275
Oct,Week 43,2021,21126,2913,24039,186275
Oct,Week 44,2021,24111,2760,26871,185438
Oct,Week 44,2021,24322,2587,26909,185438
Oct,Week 44,2021,23284,2490,25774,185438
Oct,Week 44,2021,24187,2564,26751,185438
Oct,Week 44,2021,25749,2681,28430,185438
Oct,Week 44,2021,25263,2697,27960,185438
Oct,Week 44,2021,19912,2831,22743,185438
Oct,Week 45,2021,20857,2683,23540,185115
Nov,Week 45,2021,23878,2657,26535,185115
Nov,Week 45,2021,23270,2567,25837,185115
Nov,Week 45,2021,24558,2745,27303,185115
Nov,Week 45,2021,26477,2881,29358,185115
Nov,Week 45,2021,25890,2865,28755,185115
Nov,Week 45,2021,20702,3085,23787,185115
Nov,Week 46,2021,23906,2978,26884,188240
Nov,Week 46,2021,24460,2812,27272,188240
Nov,Week 46,2021,23283,2573,25856,188240
Nov,Week 46,2021,24266,2767,27033,188240
Nov,Week 46,2021,26276,2929,29205,188240
Nov,Week 46,2021,25553,2934,28487,188240
Nov,Week 46,2021,20344,3159,23503,188240
Nov,Week 47,2021,23886,3000,26886,191395
Nov,Week 47,2021,24655,2883,27538,191395
Nov,Week 47,2021,23310,2585,25895,191395
Nov,Week 47,2021,24477,2772,27249,191395
Nov,Week 47,2021,26368,2948,29316,191395
Nov,Week 47,2021,26253,3070,29323,191395
Nov,Week 47,2021,21858,3330,25188,191395
Nov,Week 48,2021,23839,3110,26949,182033
Nov,Week 48,2021,24372,2822,27194,182033
Nov,Week 48,2021,26618,2809,29427,182033
Nov,Week 48,2021,27007,2954,29961,182033
Nov,Week 48,2021,14664,2636,17300,182033
Nov,Week 48,2021,20646,2919,23565,182033
Nov,Week 48,2021,24278,3359,27637,182033
Nov,Week 49,2021,25947,3133,29080,195265
Nov,Week 49,2021,25970,2972,28942,195265
Nov,Week 49,2021,25265,2816,28081,195265
Dec,Week 49,2021,24627,2955,27582,195265
Dec,Week 49,2021,26302,3071,29373,195265
Dec,Week 49,2021,25588,3129,28717,195265
Dec,Week 49,2021,20103,3387,23490,195265
Dec,Week 50,2021,23376,3197,26573,187267
Dec,Week 50,2021,23859,3007,26866,187267
Dec,Week 50,2021,23320,2848,26168,187267
Dec,Week 50,2021,24178,2953,27131,187267
Dec,Week 50,2021,25960,3164,29124,187267
Dec,Week 50,2021,25050,3118,28168,187267
Dec,Week 50,2021,19836,3401,23237,187267
Dec,Week 51,2021,23141,3235,26376,191785
Dec,Week 51,2021,23673,3062,26735,191785
Dec,Week 51,2021,23097,2928,26025,191785
Dec,Week 51,2021,23538,3052,26590,191785
Dec,Week 51,2021,26094,3391,29485,191785
Dec,Week 51,2021,26547,3462,30009,191785
Dec,Week 51,2021,22749,3816,26565,191785
Dec,Week 52,2021,23553,3591,27144,186544
Dec,Week 52,2021,24641,3424,28065,186544
Dec,Week 52,2021,25391,3422,28813,186544
Dec,Week 52,2021,25975,3497,29472,186544
Dec,Week 52,2021,26183,3531,29714,186544
Dec,Week 52,2021,19842,3243,23085,186544
Dec,Week 52,2021,16857,3394,20251,186544
Jan,Week 2,2022,21397,3484,24881,170770
Jan,Week 2,2022,21581,3372,24953,170770
Jan,Week 2,2022,21748,3204,24952,170770
Jan,Week 2,2022,21326,3116,24442,170770
Jan,Week 2,2022,22007,3213,25220,170770
Jan,Week 2,2022,21391,3098,24489,170770
Jan,Week 2,2022,18360,3473,21833,170770
Jan,Week 3,2022,21511,3252,24763,175418
Jan,Week 3,2022,22004,3072,25076,175418
Jan,Week 3,2022,21384,2912,24296,175418
Jan,Week 3,2022,22141,3009,25150,175418
Jan,Week 3,2022,23939,3091,27030,175418
Jan,Week 3,2022,24067,3147,27214,175418
Jan,Week 3,2022,18449,3440,21889,175418
Jan,Week 4,2022,17684,3063,20747,170787
Jan,Week 4,2022,21802,2790,24592,170787
Jan,Week 4,2022,21843,2790,24633,170787
Jan,Week 4,2022,22447,2873,25320,170787
Jan,Week 4,2022,24118,3007,27125,170787
Jan,Week 4,2022,23574,3091,26665,170787
Jan,Week 4,2022,18304,3401,21705,170787
Jan,Week 5,2022,22105,3081,25186,172723
Jan,Week 5,2022,22386,2892,25278,172723
Jan,Week 5,2022,21836,2673,24509,172723
Jan,Week 5,2022,22665,2862,25527,172723
Jan,Week 5,2022,24810,2943,27753,172723
Jan,Week 5,2022,23372,2948,26320,172723
Jan,Week 5,2022,15397,2753,18150,172723
Jan,Week 6,2022,21210,2921,24131,162188
Jan,Week 6,2022,22544,2877,25421,162188
Feb,Week 6,2022,21974,2664,24638,162188
Feb,Week 6,2022,20518,2720,23238,162188
Feb,Week 6,2022,18572,2651,21223,162188
Feb,Week 6,2022,19922,2731,22653,162188
Feb,Week 6,2022,17790,3094,20884,162188
Feb,Week 7,2022,21906,2924,24830,180272
Feb,Week 7,2022,22983,2814,25797,180272
Feb,Week 7,2022,22432,2651,25083,180272
Feb,Week 7,2022,23138,2813,25951,180272
Feb,Week 7,2022,25150,2940,28090,180272
Feb,Week 7,2022,24731,3065,27796,180272
Feb,Week 7,2022,19308,3417,22725,180272
Feb,Week 8,2022,21339,3081,24420,182608
Feb,Week 8,2022,23576,2880,26456,182608
Feb,Week 8,2022,22771,2720,25491,182608
Feb,Week 8,2022,23763,2910,26673,182608
Feb,Week 8,2022,24712,2973,27685,182608
Feb,Week 8,2022,25303,3115,28418,182608
Feb,Week 8,2022,19986,3479,23465,182608
Feb,Week 9,2022,21873,3168,25041,181446
Feb,Week 9,2022,24254,3038,27292,181446
Feb,Week 9,2022,23501,2830,26331,181446
Feb,Week 9,2022,22742,2886,25628,181446
Feb,Week 9,2022,23519,2963,26482,181446
Feb,Week 9,2022,23714,3085,26799,181446
Feb,Week 9,2022,20357,3516,23873,181446
Feb,Week 10,2022,23257,3251,26508,187468
Feb,Week 10,2022,24109,3082,27191,187468
Mar,Week 10,2022,23351,2906,26257,187468
Mar,Week 10,2022,23932,2972,26904,187468
Mar,Week 10,2022,25466,3162,28628,187468
Mar,Week 10,2022,24829,3263,28092,187468
Mar,Week 10,2022,20227,3661,23888,187468
Mar,Week 11,2022,22945,3343,26288,186635
Mar,Week 11,2022,23644,3109,26753,186635
Mar,Week 11,2022,23094,2979,26073,186635
Mar,Week 11,2022,23368,3056,26424,186635
Mar,Week 11,2022,25690,3226,28916,186635
Mar,Week 11,2022,25144,3315,28459,186635
Mar,Week 11,2022,20080,3642,23722,186635
Mar,Week 12,2022,22904,3383,26287,188812
Mar,Week 12,2022,23941,3161,27102,188812
Mar,Week 12,2022,23232,3006,26238,188812
Mar,Week 12,2022,24135,3095,27230,188812
Mar,Week 12,2022,25161,3244,28405,188812
Mar,Week 12,2022,24898,3350,28248,188812
Mar,Week 12,2022,21511,3791,25302,188812
Mar,Week 13,2022,23654,3460,27114,190397
Mar,Week 13,2022,23665,3197,26862,190397
Mar,Week 13,2022,23304,3032,26336,190397
Mar,Week 13,2022,24027,3109,27136,190397
Mar,Week 13,2022,25777,3272,29049,190397
Mar,Week 13,2022,25380,3332,28712,190397
Mar,Week 13,2022,21392,3796,25188,190397
Mar,Week 14,2022,23530,3602,27132,188431
Mar,Week 14,2022,24112,3361,27473,188431
Mar,Week 14,2022,23409,3210,26619,188431
Mar,Week 14,2022,23911,3301,27212,188431
Mar,Week 14,2022,25209,3401,28610,188431
Apr,Week 14,2022,24811,3495,28306,188431
Apr,Week 14,2022,19259,3820,23079,188431
Apr,Week 15,2022,22471,3492,25963,189924
Apr,Week 15,2022,23796,3348,27144,189924
Apr,Week 15,2022,23954,3279,27233,189924
Apr,Week 15,2022,24461,3411,27872,189924
Apr,Week 15,2022,25111,3454,28565,189924
Apr,Week 15,2022,25252,3563,28815,189924
Apr,Week 15,2022,20426,3906,24332,189924
Apr,Week 16,2022,23207,3681,26888,191962
Apr,Week 16,2022,24308,3441,27749,191962
Apr,Week 16,2022,24027,3347,27374,191962
Apr,Week 16,2022,24549,3427,27976,191962
Apr,Week 16,2022,25713,3511,29224,191962
Apr,Week 16,2022,25088,3540,28628,191962
Apr,Week 16,2022,20244,3879,24123,191962
Apr,Week 17,2022,22967,3659,26626,192662
Apr,Week 17,2022,24396,3467,27863,192662
Apr,Week 17,2022,24183,3335,27518,192662
Apr,Week 17,2022,24690,3414,28104,192662
Apr,Week 17,2022,25890,3508,29398,192662
Apr,Week 17,2022,25273,3530,28803,192662
Apr,Week 17,2022,20494,3856,24350,192662
Apr,Week 18,2022,23524,3659,27183,193114
Apr,Week 18,2022,24201,3427,27628,193114
Apr,Week 18,2022,24085,3327,27412,193114
Apr,Week 18,2022,24809,3415,28224,193114
Apr,Week 18,2022,25933,3512,29445,193114
Apr,Week 18,2022,25398,3539,28937,193114
Apr,Week 18,2022,20491,3794,24285,193114
May,Week 19,2022,23137,4726,27863,200380
May,Week 19,2022,24193,4511,28704,200380
May,Week 19,2022,24151,4433,28584,200380
May,Week 19,2022,24673,4438,29111,200380
May,Week 19,2022,26246,4630,30876,200380
May,Week 19,2022,25422,4597,30019,200380
May,Week 19,2022,20480,4743,25223,200380
May,Week 20,2022,23529,4604,28133,201099
May,Week 20,2022,24611,4549,29160,201099
May,Week 20,2022,24126,4422,28548,201099
May,Week 20,2022,24807,4532,29339,201099
May,Week 20,2022,26241,4629,30870,201099
May,Week 20,2022,25307,4649,29956,201099
May,Week 20,2022,20287,4806,25093,201099
May,Week 21,2022,23497,4635,28132,199774
May,Week 21,2022,23775,4446,28221,199774
May,Week 21,2022,24190,4468,28658,199774
May,Week 21,2022,24727,4559,29286,199774
May,Week 21,2022,26296,4720,31016,199774
May,Week 21,2022,24856,4682,29538,199774
May,Week 21,2022,20113,4810,24923,199774
May,Week 22,2022,22789,4655,27444,199552
May,Week 22,2022,24119,4631,28750,199552
May,Week 22,2022,23863,4518,28381,199552
May,Week 22,2022,24745,4622,29367,199552
May,Week 22,2022,26292,4850,31142,199552
May,Week 22,2022,24833,4786,29619,199552
May,Week 22,2022,19964,4885,24849,199552
May,Week 23,2022,21868,4703,26571,195755
May,Week 23,2022,23477,4681,28158,195755
May,Week 23,2022,23378,4574,27952,195755
Jun,Week 23,2022,23991,4664,28655,195755
Jun,Week 23,2022,24645,4700,29345,195755
Jun,Week 23,2022,24873,4808,29681,195755
Jun,Week 23,2022,20339,5054,25393,195755
Jun,Week 24,2022,23974,4962,28936,206716
Jun,Week 24,2022,24765,4867,29632,206716
Jun,Week 24,2022,24576,4768,29344,206716
Jun,Week 24,2022,25302,4837,30139,206716
Jun,Week 24,2022,26306,4966,31272,206716
Jun,Week 24,2022,25697,5032,30729,206716
Jun,Week 24,2022,21454,5210,26664,206716
Jun,Week 25,2022,23722,5039,28761,204914
Jun,Week 25,2022,24867,4865,29732,204914
Jun,Week 25,2022,24723,4800,29523,204914
Jun,Week 25,2022,25474,4927,30401,204914
Jun,Week 25,2022,24974,4942,29916,204914
Jun,Week 25,2022,25042,5015,30057,204914
Jun,Week 25,2022,21299,5225,26524,204914
Jun,Week 26,2022,23453,4987,28440,205787
Jun,Week 26,2022,24874,4974,29848,205787
Jun,Week 26,2022,24900,4840,29740,205787
Jun,Week 26,2022,24297,4834,29131,205787
Jun,Week 26,2022,26197,5044,31241,205787
Jun,Week 26,2022,25557,5037,30594,205787
Jun,Week 26,2022,21515,5278,26793,205787
Jun,Week 27,2022,23537,5048,28585,205679
Jun,Week 27,2022,24369,4889,29258,205679
Jun,Week 27,2022,24396,4791,29187,205679
Jun,Week 27,2022,25265,4880,30145,205679
Jun,Week 27,2022,26352,5081,31433,205679
Jul,Week 27,2022,25664,4988,30652,205679
Jul,Week 27,2022,21160,5259,26419,205679
Jul,Week 28,2022,21381,4996,26377,198602
Jul,Week 28,2022,22057,4855,26912,198602
Jul,Week 28,2022,23338,4857,28195,198602
Jul,Week 28,2022,24401,4897,29298,198602
Jul,Week 28,2022,25609,5084,30693,198602
Jul,Week 28,2022,25167,5041,30208,198602
Jul,Week 28,2022,21659,5260,26919,198602
Jul,Week 29,2022,23968,5096,29064,207288
Jul,Week 29,2022,24943,4940,29883,207288
Jul,Week 29,2022,24242,4831,29073,207288
Jul,Week 29,2022,25136,4966,30102,207288
Jul,Week 29,2022,26331,5083,31414,207288
Jul,Week 29,2022,25714,5052,30766,207288
Jul,Week 29,2022,21667,5319,26986,207288
Jul,Week 30,2022,23886,5081,28967,206522
Jul,Week 30,2022,24242,4877,29119,206522
Jul,Week 30,2022,24584,4827,29411,206522
Jul,Week 30,2022,25183,4931,30114,206522
Jul,Week 30,2022,26394,5071,31465,206522
Jul,Week 30,2022,25826,5050,30876,206522
Jul,Week 30,2022,21244,5326,26570,206522
Jul,Week 31,2022,23549,5032,28581,205659
Jul,Week 31,2022,23992,4873,28865,205659
Jul,Week 31,2022,24348,4747,29095,205659
Jul,Week 31,2022,25207,4949,30156,205659
Jul,Week 31,2022,26115,5081,31196,205659
Jul,Week 31,2022,25765,5035,30800,205659
Jul,Week 31,2022,21591,5375,26966,205659
Jul,Week 32,2022,23752,5034,28786,203600
Aug,Week 32,2022,24863,4918,29781,203600
Aug,Week 32,2022,24385,4888,29273,203600
Aug,Week 32,2022,24482,4972,29454,203600
Aug,Week 32,2022,25203,4998,30201,203600
Aug,Week 32,2022,24387,5049,29436,203600
Aug,Week 32,2022,21301,5368,26669,203600
Aug,Week 33,2022,23205,5063,28268,204662
Aug,Week 33,2022,24415,4925,29340,204662
Aug,Week 33,2022,24497,4870,29367,204662
Aug,Week 33,2022,24388,4925,29313,204662
Aug,Week 33,2022,25861,5039,30900,204662
Aug,Week 33,2022,25646,5033,30679,204662
Aug,Week 33,2022,21503,5292,26795,204662
Aug,Week 34,2022,23841,5090,28931,205038
Aug,Week 34,2022,24619,4945,29564,205038
Aug,Week 34,2022,24549,4713,29262,205038
Aug,Week 34,2022,24878,4852,29730,205038
Aug,Week 34,2022,25938,4968,30906,205038
Aug,Week 34,2022,25571,4955,30526,205038
Aug,Week 34,2022,21053,5066,26119,205038
